SO ./assets/textures/Brick_10-512x512.xpm






                            
                     
EA ./assets/textures/Metal_08-512x512.xpm




NO ./assets/textures/Stone_14-512x512.xpm




WE ./assets/textures/Metal_08-512x512.xpm




C 135,206,25




F 47,82,65





        1111111111111111111111111
        1000000110000000000000001
        1011000000E00000000000001
        1001000000000000010000001
111111111011000001110000000000001
100000000011000001110111110011111
11110111111 11011100000010001 
11110111111111011101010010001
10000000110101011100000100001
10000000000000001100000010001
10000000000000001101010010001
11000001110101011111011110011
11110111 1110101 101111010001
11111111 1111111 111111111111