NO ./assets/textures/north.xpm
SO ./assets/textures/west.xpm
WE ./assets/textures/west.xpm
EA ./assets/textures/east.xpm

C 0,0,0
F 222,222,222              

                         111111111
           1            10000000001
                        10000000001
                         100000001 
 1111    111111111111111111000001
10001    100000000000000000000001
10011111101111111111111111000001
10001    100000000000000001111111
11011    111111111111001101                           111111 
100011111110000000000000001                          10000001 
10001000011011111111111111111111111111111           1000000001 
1000000001101               1000000000001          100000000001 
1000100001101               100000000000111111111110000000000001
10001111111011111111111111111000000000000000000000000000000000011111111111
100011000000000000000000000010000000000100000000000111111111110000000000001 
1000110000000000000000000000111111111111000000000001          100000000001 
1000110000000000000000000000111111111111000000000001           1000000001 
1000110000000000000000000000000001111111110111111111            10000001 
100011000000000000000000000011111111111111011                    111111 
10000100000000000000000000001           10001
10000000000000000000000000001   1       10001
10000000000000000000000000001  1N1      10001
1000000000000000000000000001   101     10001 
10000000000000000000000000001  101     10001
10000000000000000000000000001  101    10001
10000000000000000000000000001  101   10001
100011111111111111111111100011110111100001
10001            1111111100000000000000001
1001          111000001100111111111111111
101         110000000000001
101        10000000000000001
101       1000000000000000001
101111111100000000000000000001
100000000000000000000000000001
111111111100000000000000000001
1         1000000000000000001
1          10000000000000001
1           110000000000011
1             11100000111
1                11011
1                  1     
1                  1