NO ./path_to_the_north_texture
SO ./path_to_the_south_texture
WE ./path_to_the_west_texture
EA ./path_to_the_east_texture 

F 220,100,0
C 225,30,0


                        1111111111111111111111111
                        100000001  1000000000001   
                        1011000011110000000000001111111           11111111111111111     |
                        1001000000000000000000000000001            11111111111111111    |
                111111111011000001110000000000001111111     111111111111111111          | palece holders ' ' for segs
                100000000011000001110111111111111           101111111111111111
                11110111111111011100000010001      111      111   
                11110111111111011101010010001      101      101   
                11000000110101011100000010001      101      101   
                10000000000000001100000010001      101      101   
                10000000000000001101010010001      111      101   
                11000001110101011111011110N0111           11101111111111
                11110111 1110101 101111010001             10000000000001
                11111111 1111111 111111111111             11111111111111


                // notes :      first line all 1s 
                                when ever i start a wall check 


        loop over spaces wen i find smthing check top line for 1 and bottom line for 1

0 check for all directions if 0 sourended by 1 or another 0 or player 