   
NO ./texture/1c61b0435af5cc9d01a1a3364ae31abc.xpm
SO ./texture/east.xpm
F 0,19,255
EA ./texture/ross-elder-uXQVNkam3hE-unsplash.xpm
WE ./texture/sprite.xpm
C 255,1,0
 1
1N1
 1
111
1011
1111