   
NO ./texture/1c61b0435af5cc9d01a1a3364ae31abc.xpm

SO ./texture/east.xpm


F 0,19,255

EA ./texture/ross-elder-uXQVNkam3hE-unsplash.xpm

   
WE ./texture/sprite.xpm
    
C 255,1,0   


111111111111111111111111111111111111111111111111111111111111111111111111
100011111111111
100000100000001
10000111111111111111111111
10000000000000000000110001
10000011000000000000010001
10000011000000000000000001
11111111001111111111110001
110000000000001       10001
110000000000001  1    10001
101001010000001 101   10001
100000010000001  1    11011
10000000000001       11011
111111111111111111111111111111111111111111111111
10000001000000000000000000000000001
101001010000001000000E00000000000011111
110000110000001001100000000000110011011
111111111111111001100000000000110010001
              1000000000000000000010001
              1000000000000000000000001
              1000000000100000000000001
              1000000000000000000010001
              1000000000000000000010001
              1001100000000000110010001
              1001100000000000110010001
              1000000000000000000010001
              1000000000000000000010001
              1111111111111111111110001
                                  10001
                               11110001111
                               10000000001
   1111111111111               10000000001
   1000000000001               10000000001
   1000000000001               10000000001
   1000000000001              10000000001
   1000000000001               10100000101
   1000000000001               10001010001
   10011111111111111111111     11110011111
   10000000000000000000001       100001
   11110000000000000000001       100001
      10000000000000000001       100001
11111111111111111111111111111111111111111111111111111111111111111111111
