
NO ./assets/textures/wall1.png

SO ./assets/textures/wall1.png
WE ./assets/textures/wall1.png
EA ./assets/textures/wall1.png

F 124,142,12
C 12,220,125

111111111111111111111
10000N000000000000001
111100000000000000001
100000000000000000001
100000000000000001001
101000000000000001011
100000000000000001001
111111111111111111111