NO ./assets/textures/walls/wall2.png     

       
SO ./assets/textures/walls/wall3.png
WE ./assets/textures/walls/wall1.png
                   
        
EA ./assets/textures/walls/wall4.png


C 0,0,0
F 128,128,128


11111111111111111111111       
10111111111111111111111       
100000000000000000000101       
100000101000010000001111       
1000000W000001000000111111111
100000000000010000001
100000101100100000001
100000000000000000001
111111111111111111111
