NO ./assets/textures/walls/wall1.png     

       
SO ./assets/textures/walls/wall2.png
WE ./assets/textures/walls/wall3.png
                   
        
EA ./assets/textures/walls/wall4.png


F 255,142,122
C 12,220,252


11111111111111111111111       
101111111111111111111         
100000000000000000001        
100000000000000000001        
1000000W000000000000111111111
100000000000000000001
100000000000000000001
100000000000000000001
111111111111111111111
